****************************
*............**............*
*.****.*****.**.*****.****.*
*.****.*****.**.*****.****.*						  
*.****.*****.**.*****.****.*						  
*..........................*
*.****.**.********.**.****.*						  
*.****.**.********.**.****.*
*......**....**....**......*						  
******.***** ** *****.******				
     *.***** ** *****.*     				  
     *.**          **.*     				  
     *.** ***  *** **.*     				  
******.** *      * **.******
      .** *      * **.      					  
******.   *      *   .******				
     *.** ******** **.*       
     *.**          **.*     
     *.** ******** **.*     
******.   ********   .******
*............**............*
*.****.*****.**.*****.****.*
*.****.*****.**.*****.****.*
*...**................**...*
*...**................**...*
***.**.**.********.**.**.***						  
*......**....**....**......*						  
*.**********.**.*********..*						  
*..........................*
****************************