*********************
*         *         * 
* ****    *    **** * 
*                   *
* ***   *****   *** *
* *       *       * *
* * ****  *   *** * *
* * *           * * *
*   * **     ** *   *
***   *       *   ***
*     * *   * *     *
*     * *   * *     *
*     *********     *
* ***           *** *
* *               * *
* * ************* * *
* * *           * * *
* *      ***      * *
*   ***       ***   *
*********************