*********************
*         *         * 
* ****    *    **** * 
*                   *
* ***   *****   *** *
* *       *       * *
* * ****  *   *** * *
* * *           * * *
*   * **     ** *   *
***   * ** ** *   ***
*     * *   * *     *
*     * ***** *     *
*     *********     *
* ***           *** *
* *               * *
* * ************* * *
* * *           * * *
* *      ***      * *
*   ***       ***   *
*********************